Progression,100
20,10
W,W,W,W,W,W,W,W,W,W,W,W,W,W,W,W,W,W,W,W
W,P,W,E,Lr,P,P,P,P,C2,P,P,P,P,P,P,P,P,P,W
W,T1,W,P,P,P,P,P,P,P,P,P,P,D,D,D,D,P,P,W
W,P,W,W,P,P,W,P,P,P,P,P,P,P,P,P,P,P,P,W
W,P,P,W,P,P,Inn,P,P,P,Ird,Ild,P,P,P,P,P,P,P,W
W,P,P,W,P,B1,P,P,P,P,P,Iud,P,A,A,A,A,A,A,W
W,W,W,W,P,P,P,P,P,P,P,P,P,P,P,P,P,P,P,W
W,P,T1,W,P,P,P,P,P,P,W,P,P,P,P,P,P,P,P,W
W,P,P,W,P,P,P,P,P,P,P,P,P,P,P,P,P,P,P,W
W,W,W,W,W,W,W,W,W,W,W,W,W,W,W,W,W,W,W,W
K,5,1,r
Pl,10,5
CC,18,4
CC,18,3
Pi,1,2,u
F,1,8
Bu,1,5,l,u
Bl,6,6