Avoidance,60
15,10
W,W,W,W,W,W,#,W,W,W,W,W,W,W,W
W,E,W,P,P,W,W,W,P,P,W,P,P,P,W
W,Lr,W,P,P,P,P,P,P,P,D,P,P,P,W
W,Lg,W,P,P,W,W,W,P,P,W,P,P,P,W
W,P,P,P,W,W,#,W,W,W,W,P,P,P,W
W,D,D,D,W,#,#,#,#,#,W,P,P,P,W
W,W,C2,W,W,W,W,#,#,#,W,W,W,W,W
W,P,P,P,P,P,W,#,#,#,#,#,#,#,#
W,P,P,P,P,P,W,#,#,#,#,#,#,#,#
W,W,W,W,W,W,W,#,#,#,#,#,#,#,#
Pl,3,1
F,3,8
K,3,8,g
F,13,3
K,13,3,r
CC,1,5
CC,9,1
