Avoidance,50
15,10
W,W,W,W,W,W,W,W,W,W,W,W,W,W,W
W,P,A,A,P,P,P,P,A,A,P,W,P,E,W
W,P,A,A,P,A,A,P,A,A,P,W,P,P,W
W,P,Ilr,Ilr,P,A,A,P,A,A,P,W,Lr,W,W
W,P,A,A,P,A,A,P,A,A,P,P,P,P,W
W,P,P,P,P,A,A,P,P,P,P,P,P,P,W
W,W,W,W,W,W,W,W,W,W,W,W,W,P,W
W,P,P,P,W,P,P,P,P,P,P,P,P,P,W
W,P,P,P,C2,P,D,D,D,D,D,D,D,D,W
W,W,W,W,W,W,W,W,W,W,W,W,W,W,W
K,1,8,r
CC,3,3
CC,12,5
Bu,1,8,r,r
Pi,5,7,r
Pl,1,1
F,5,1