Test,500
10,10
W,W,W,W,W,W,W,W,W,W
W,A,D,P,D,P,D,P,D,W
W,D,P,D,P,D,P,D,P,W
W,P,D,P,D,P,D,P,D,W
W,D,P,D,P,D,P,D,P,W
W,P,D,P,D,P,D,P,D,W
W,D,P,D,P,D,W,D,W,W
W,P,D,P,D,P,W,P,D,W
W,D,P,D,P,D,W,D,P,W
W,W,W,W,W,W,W,W,W,W
CC,5,2
K,4,2,r
Pl,6,2
F,7,1
Bu,6,1,l,r
Pi,5,1,d
Bl,4,1